10,10
000000X000
0X0X0X0000
000X000X00
0X000000X0
00X0GX0000
0X00X0000X
000000X0X0
0000000000
00X0X0XX00
0X00000000

