9,8
X0000000X
00X0X0X00
X0X0X0X0X
00X0X0X00
X0X0X0X0X
00X0X0X0G
X0X0X0X0X
X0000000X

